v___v_v_v___v___v
#   # # #   #   #
#   # # #   #   #
^_v_| # |_v_|___|
  # # # # # #   #
  # |_^_| # #   #
  # #   # # #   #
v_|_|   # # |_v_^
# # #   # # # #  
# # |___|_^_| #  
# # #   #   # #  
# # #   #   |_|_v
# # #   #   # # #
|_^_|___|___| # #
#   #   #   # # #
#   #   #   # # #
^___^___^___^_^_^