vv____vv_vv_vv____vv____vv
##    ## ## ##    ##    ##
##    ## ## ##    ##    ##
##    ## ## ##    ##    ##
^^_vv_|| ## ||_vv_||____||
   ## ## ## ## ## ##    ##
   ## ||_^^_|| ## ##    ##
   ## ##    ## ## ##    ##
vv_||_||    ## ## ||_vv_^^
## ## ##    ## ## ## ##   
## ## ||____||_^^_|| ##   
## ## ##    ##    ## ##   
## ## ##    ##    ||_||_vv
## ## ##    ##    ## ## ##
||_^^_||____||____|| ## ##
##    ##    ##    ## ## ##
##    ##    ##    ## ## ##
##    ##    ##    ## ## ##
^^____^^____^^____^^_^^_^^