v___v_v___v_____v
#   # #   #     #
|___|_^_v_^_v___|
#   #   #   #   #
|___^_v_|   |___|
#     # #   #   #
^___v_|_|_v_^___^
    # # # #      
    | # |_^_v    
    # # #   #    
    |_^_^___|    
    #       #    
    |       #    
    #       #    
v_v_|       |___v
# # #       #   #
|_|_|       |_v_|
# # #       # # #
^_^_|       |_^_^
    #       #    
    |_v___v_|    
    # #   # #    
    ^_^___^_^    