vv____vv_vv____vv_______vv
##    ## ##    ##       ##
||____||_^^_vv_^^_vv____||
##    ##    ##    ##    ##
||____^^_vv_||    ||____||
##       ## ##    ##    ##
^^____vv_||_||_vv_^^____^^
      ## ## ## ##         
      || ## ||_^^_vv      
      ## ## ##    ##      
      ||_^^_^^____||      
      ##          ##      
      ||          ##      
      ##          ##      
vv_vv_||          ||____vv
## ## ##          ##    ##
||_||_||          ||_vv_||
## ## ##          ## ## ##
^^_^^_||          ||_^^_^^
      ##          ##      
      ||_vv____vv_||      
      ## ##    ## ##      
      ^^_^^____^^_^^      