v___v___v___v___v
#   #   #   #   #
^_v_^_v_^_v_^_v_^
  #   #   #   #  
v_^_v_^_v_^_v_^_v
#   #   #   #   #
^_v_^_v_^_v_^_v_^
  #   #   #   #  
v_^_v_^_v_^_v_^_v
#   #   #   #   #
|_v_^_v_^_v_^_v_|
# #   #   #   # #
|_^_v_^_v_^_v_^_|
#   #   #   #   #
^___^___^___^___^