vv____vv____vv____vv____vv
##    ##    ##    ##    ##
^^_vv_^^_vv_^^_vv_^^_vv_^^
   ##    ##    ##    ##   
vv_^^_vv_^^_vv_^^_vv_^^_vv
##    ##    ##    ##    ##
^^_vv_^^_vv_^^_vv_^^_vv_^^
   ##    ##    ##    ##   
vv_^^_vv_^^_vv_^^_vv_^^_vv
##    ##    ##    ##    ##
||_vv_^^_vv_^^_vv_^^_vv_||
## ##    ##    ##    ## ##
||_^^_vv_^^_vv_^^_vv_^^_||
##    ##    ##    ##    ##
^^____^^____^^____^^____^^
                          
                          
                          
                          
                          
                          
                          
                          
 -uuuu--uuuu--uuuu--uuuu- 