vv___________________vv_vv
##                   ## ##
^^__________vv____vv_||_||
            ##    ## ## ##
vv__________^^____^^ ## ##
##                   ## ##
||________________vv ## ##
##                ## ## ##
||____vv__________^^_||_||
##    ##          ## ## ##
||____||__________|| ## ##
##                ## ## ##
||________________|| ## ##
##                ## ## ##
||________________|| ## ##
##                ## ## ##
##                ||_^^_||
##                ##    ##
##                ##    ##
##                ##    ##
##                ##    ##
##                ##    ##
^^                ^^____^^
       -uuuu--uuuu-       