v_____________v_v
#             # #
^_______v___v_|_|
        #   # # #
v_______^___^ # #
#             # #
|___________v # #
#           # # #
|___v_______^_|_|
#   #         # #
|___|_______v # #
#           # # #
|___________| # #
#           # # #
|___________^ # #
#             # #
#           v_^_|
#           #   #
#           #   #
#           #   #
#           #   #
#           #   #
^           ^___^