      vv_vv___    vv______
      ## ##       ##      
______|| ## ___vv_^^      
      ## ##    ##         
      ||_||_vv ## vv______
      ## ## ## ## ##      
______^^ ## ||_^^_||      
         ## ##    ##      
      vv_^^_||    ||______
      ##    ##    ##      
______||    ^^_vv_^^      
      ##       ##         
      ||_vv_vv ## vv______
      ## ## ## ## ##      
______^^ ## ^^_||_||      
         ##    ## ##      
      vv_^^_vv ## ||______
      ##    ## ## ##      
______^^    ^^_^^_^^      
                          
                          
                          
                          
 -uuuu--uuuu--uuuu--uuuu- 