    v_v__   v____
    # #     #    
____| # __v_^    
    # #   #      
    |_|_v # v____
    # # # # #    
____^ # |_^_|    
      # #   #    
    v_^_|   |____
    #   #   #    
____|   ^_v_^    
    #     #      
    |_v_v # v____
    # # # # #    
____^ # ^_|_|    
      #   # #    
    v_^_v # |____
    #   # # #    
____^   ^_^_^    